R 800 600 
NO ./img/north.xpm
SO ./img/south.xpm
EA ./img/east.xpm
WE ./img/west.xpm

S ./img/sprite.xpm
F 14,197,63
C 173,249,253

111111111111111111111111111111
111111111000200000000000011111
100000000000000000111000100001
110000100000000000000000001111
100001111111000000020000111111
1111111000000000W0000000000001
111100000000001100000002000011
100000000000000000000000000001
110000000000011110000000000011
100000000000111000000000000011
110000000000111000000000001111
110000000001111000000000000111
111111111111111111111111111111
