SO ./img/south.xpm
NO ./img/north.xpm
WE ./img/west.xpm
EA ./img/east.xpm
C 51,0,155
F 249,0,155
111111
100001
100E01
100001
100001
111111