SO ./img/south.xpm
NO ./img/north.xpm
WE ./img/west.xpm
EA ./img/east.xpm
C 51,0,155
F 249,0,155


111111111111111111111111111111
111111111000000000000000011111
100000000000000000111000100001
110000100000000000000000001111
1000011111110000S0000000111111
111111100000000000000000000001
111100000000001100000000000011
100000000000000000000000000001
110000000000011110000000000011
100000000000111000000000000011
110000000000111000000000001111
110000000001111000000000000111
111111111111111111111111111111