NO ./img/spaceship/wall_1.xpm
SO ./img/spaceship/wall_2.xpm
EA ./img/spaceship/wall_3.xpm
WE ./img/spaceship/wall_4.xpm
F 102,102,153
C 128,128,128
111111111111111111111111111111
111111111000000000000000011111
100000000000000000111000100001
110001000E00000000000000001111
100001111111000000000000111111
111111100000000000000000000001
111100000000001100000000000011
100000000000000000000000000001
110000000000011110000000000011
100000000000111000000000000011
110000000000111000000000001111
110000000001111000000000000111
111111111111111111111111111111