NO	./img/spaceship/wall_1.xpm
SO 	./img/spaceship/wall_2.xpm
EA 	./img/spaceship/wall_3.xpm
WE 	./img/spaceship/wall_4.xpm

C 128,128,128
F 102,102,153



1111111111111111111111
11111111111111000000111111111111111
           100000000000000000000001
11111111111111001111111111110111111
1000000000000000001111     101
1100010000000000000001     101
1000011111110000N00001     101
111111100000000000000111111101
111100000000000000000000000001
100000000000000000001111111111    
1100000000000111100001
1111111111111111101111
                101
                101
                101
                111