NO ./img/spaceship/wall_1.xpm
SO ./img/spaceship/wall_2.xpm
EA ./img/spaceship/wall_3.xpm
WE ./img/spaceship/wall_4.xpm

F 102,102,153
C 128,128,128

1111111111111111111111
1111111111111110000001
1000000000000000001111
1100010000000000000001
1000011111110000000001
1111111000000000000001
1111000000000011000001
1000000000000000000011
110000000E000111100001
1111111111111111111111